################################
#                   ############
#    ###  ####      ##    ######
#  #############          ######
#  ##############            ###
#  %%%%%%%%%%*###              #
#   ############               #
#     #########      ##        #
#            ##     ###        #
#                  ####        #
#   ##            ######       #
#   ####        ########       #
#   #####       #########      #
#    ####      ##########      #
##   # ##      ############   t#
####           ############   t#
####                           #
################################